15
15
8 8 8 8 8 8 8 8 8 8 8 8 8 8 8 
8 8 8 8 8 8 8 8 8 8 8 8 8 8 8 
8 8 8 8 8 8 8 8 8 8 8 8 8 8 8 
8 8 8 8 8 8 8 8 8 8 8 8 8 8 8 
8 2 8 8 8 8 8 8 8 8 8 8 8 2 8 
8 2 1 1 1 1 1 1 1 1 1 1 1 2 8 
8 2 8 8 8 8 8 8 8 8 8 8 8 2 8 
8 2 8 8 8 8 8 8 8 8 8 8 8 2 8 
8 2 8 8 8 8 8 8 8 8 8 8 8 2 8 
8 2 1 1 1 1 1 1 1 1 1 1 1 2 8 
8 2 8 8 8 8 8 8 8 8 8 8 8 2 8 
8 2 8 8 8 8 8 8 8 8 8 8 8 2 8 
8 8 8 8 8 8 8 8 8 8 8 8 8 2 8 
8 8 8 8 8 8 8 8 8 8 8 8 8 8 8 
8 8 8 8 8 8 8 8 8 8 8 8 8 8 8 