20
10
2 3 3 3 3 3 3 3 3 3 3 3 3 3 3 3 3 3 3 3 
2 3 3 3 3 3 3 3 3 3 3 3 3 3 3 3 3 3 3 3 
2 1 1 1 1 1 1 1 1 1 1 1 1 1 1 1 1 1 1 1 
2 8 8 8 8 8 8 8 8 8 8 8 8 8 8 8 8 8 3 3 
2 8 8 8 8 8 8 8 8 8 8 8 8 8 8 8 8 8 8 8 
2 8 8 8 8 8 8 8 8 8 8 8 8 8 8 8 8 8 8 8 
2 8 8 8 8 8 8 8 8 8 8 8 8 8 8 8 8 8 3 3 
2 1 1 1 1 1 1 1 1 1 1 1 1 1 1 1 1 1 1 1 
2 3 3 3 3 3 3 3 3 3 3 3 3 3 3 3 3 3 3 3 
2 3 3 3 3 3 3 3 3 3 3 3 3 3 3 3 3 3 3 3 
