20
15
0 0 22 22 22 22 22 22 22 22 22 22 22 22 22 22 22 22 22 22 
22 0 0 0 0 0 0 0 0 0 0 0 0 0 0 0 0 0 0 22 
22 0 0 0 0 0 0 0 22 0 0 0 0 22 22 22 22 22 0 22 
22 0 0 0 0 0 0 0 22 0 0 0 0 22 0 0 0 22 0 22 
22 0 0 0 0 0 0 0 22 0 0 0 0 22 0 0 0 22 0 22 
22 0 0 0 0 0 0 0 0 0 0 0 0 22 0 22 22 22 0 22 
22 0 0 0 0 0 0 0 0 0 0 0 0 22 0 0 0 22 0 22 
22 0 0 0 0 0 0 0 0 0 0 0 0 0 0 0 0 22 0 22 
22 0 0 0 21 21 21 0 0 0 0 0 0 0 0 0 0 22 0 22 
22 0 0 0 0 0 0 0 0 0 0 0 0 0 22 22 22 22 0 22 
22 0 0 0 0 0 0 0 0 0 0 0 0 0 0 0 0 0 0 22 
22 0 0 0 0 0 0 0 0 0 0 0 0 0 0 0 0 0 0 22 
22 0 0 0 0 0 0 0 0 23 24 25 0 0 0 0 0 0 0 22 
22 0 0 0 0 0 0 0 0 0 0 0 0 0 0 0 0 0 0 22 
22 22 22 22 22 22 22 22 22 22 22 22 22 22 22 22 22 22 22 22 
