20
15
22 22 22 22 22 22 22 22 22 22 22 22 22 22 22 22 22 22 22 22 
22 19 17 17 17 17 17 17 17 17 17 17 17 17 17 17 17 17 18 22 
22 4 0 0 0 0 0 0 0 0 0 10 1 21 2 1 21 2 3 22 
22 4 0 0 0 0 0 0 0 0 0 0 3 22 4 3 22 4 3 22 
22 4 11 0 1 21 21 21 21 21 2 11 3 22 4 3 22 4 3 22 
22 4 0 0 0 9 10 0 0 0 0 0 3 22 22 22 22 4 3 22 
22 4 0 10 0 0 0 0 0 0 0 0 9 17 17 17 17 0 3 22 
22 4 0 0 0 0 0 9 0 10 0 0 0 0 10 0 0 9 3 22 
22 4 0 0 11 0 0 0 0 0 0 0 0 0 0 0 0 0 3 22 
22 4 0 0 9 9 9 0 0 0 0 0 9 9 0 0 0 0 3 22 
22 4 0 1 21 21 21 2 11 0 0 23 24 24 25 0 10 0 3 22 
22 4 0 0 0 0 0 0 0 0 0 0 0 0 0 0 0 0 3 22 
22 4 0 9 0 0 0 0 9 0 0 10 0 0 11 0 0 9 3 22 
22 21 21 21 21 21 21 21 21 21 21 21 21 21 21 21 21 21 21 22 
22 22 22 22 22 22 22 22 22 22 22 22 22 22 22 22 22 22 22 22 
